NO ./textures/color_stone.xpm
SO ./textures/color_stone.xpm
EA ./textures/color_stone.xpm
WE ./textures/wood.xpm

F 51,51,51
C 85,85,85

11111111111111111111111111111
10000000000000000000000000001
10000000000000000000000000001
1000000000000D000000000000001
10000000000000000000000000001
100000000000000N00000000000001
10000000000000000000000000001
1000000000000D000000000000001
10000000000000000000000000001
10000000000000000000000000001
10000000000000000000000000001
10000000000000000000000000001
10000000000000000000000000001
10000000000000000000000000001
11111111111111111111111111111
